8 17
MMMMMUMMUMMMMMUMM
MMMMMUUUUUMMMMUMM
UUUUMMMMMUMMMMUMM
MMMUUUUUUUUUUUUMM
MMMUMMUMMMMMMMMMM
UUUUMMUUUUUMMMMMM
MMMMMMMMMMMMMMMMM
MMMMMMMMMMMMMMMMM
VH 5 10
POWER 1000