7 10
UUUUUUUMMM
UMMMUMUMMM
UUUUUUUUUU
UMMUMMMUMU
UMMUUMMUMU
UMMMUMMUMU
UUUUUMMUUU
VH 2 4
POWER 1000