5 10
UUUUUUUUUU
UMMMUMMMMU
UUUUUMMMMU
UMMMUMMMMU
UUUUUUUUUU
VH 2 4
POWER 1000