8 17
MMMMMUMMUMMMMMMMM
MMMMMUUUUUMMMMMMM
UUUUMMMMMUMMMMMMM
MMMUUUUUUUMMMMMMM
MMMUMMUMMMMMMMMMM
UUUUMMUUUUUMMMMMM
MMMMMMMMMMMMMMMMM
MMMMMMMMMMMMMMMMM
VH 5 10
POWER 1000