8 17
MMMMMUMMUMMMMMMMM
MMMMMUUUUUMMMMMMM
UUUUMMMMMUMMMMMMM
MMMUUUUUUUUUUUUMM
MMMUMMUMMUMMMMUMM
UUUUMMMMMUMMMMUMM
MMMMMMMMMUMMMMUMM
MMMMMMMMMUMMMMUMM
VH 4 14
POWER 300