8 17
MMMMMUMMUMMMMMMMM
MMMMMUUUUUMMMMMMM
UUUUMMMMMUMMMMMMM
MMMUUUUUUUUUUUUMM
MMMUMMUMMUMMMMUMM
UUUUMMMMMUMMMMUMM
MMMMMMMMMUMMMMUMM
MMMMMMMMMUMMMMUMM
VH 7 14
POWER 1000