12 16
MUUUUMMMMMMUUUUU
MUMUMMMMMMMUMUMM
MUMUMMMMMMMUMUMM
MUUUUUUUMMMUUUMM
MMMMMMMUUUUUMMMM
MMMMMMMUMMMMMMMM
UUUMMMUUMMMMMMMU
MMUMMMUUUUUUUUUU
MMUUUUUMMMMUUUMU
MMMUMMMMUUUUMUMM
MMMUUMMMUMMMMUUM
MMMMUUUUUMMMMMUU
VH 7 7
POWER 600
PLUSENEMY 20