14 20
UUUUMMMMMMMMMUUUUMMM
UMMUMMMMMMMMUUMMMMMM
UMMUMMMMMMMMUMMMMMMM
UMMUMMMMMMMMUUMUUUUU
UUUUMMMMMMMMMUUUMMMM
MMMUUUUUMMMMMUMMMMMM
MMMMMMMUUUUUMUMMMMMM
MMMMMMMUUUMUMUUUUUUU
MMMMMMMUUUMUUUMUMUMU
MMMMMUUUMUMMMUMUUUMU
UUUUUUMMMUUUUUMUMUMU
UMMMUMMUUUMMMUMUMUMU
UMMMUMMUMUUUUUMUUUMU
UUUUUMMUUUMMMUUUMUUU
VH 7 8
POWER 1200
PLUSENEMY 50