14 16
MMMMMMMMUUUUUUUU
MMMMMMMMUMMMMMMU
MMMMMMMMUMMMMMMU
UUUUUUUUUUUUUUUU
MMUMMMMUUMUMMMMM
MMUMMMMUUUUMMMMM
MMUMMUUUUUUUMMMM
MMUMMUMUUUMUMMMM
MMUMMUMMUMMUMMMM
MMUMMUUUUUUUUUMM
MMUMMMMMUMMMMUUM
MMUMMMMMUMMMMMUU
MMUMMMMMUMMMMMMM
MMUUUUUUUMMMMMMM
VH 7 8
POWER 1200
PLUSENEMY 50